000000300
400009001
700200050
000020840
040306010
076050000
060007003
300500002
005000000