720600009
004506001
050000000
002050000
031000970
000040800
000000600
600004500
500001032